111111111111111
10010000000C111
1000011111001C1
1P0011E00000111
111111111111111
111111111111111