1111111111111111111111111111111111111111111111111111111111111111
10C10000000000000000000000000000000CCCCCCCCCCCCCCCCCEEEEEEEEEEE1
10000111110010000000000000000000CCC00000000000000000000001111111
1P0011E000001111111111100000000000000000000000000000000000001111
111111EC1111111111110000C000000000000000000000000000000000000011
1111111111111000000000000000000000000000000000000000000000C00001
1111111111000000000000000000000000000000000000000000000000C00001
1111111100011000000000000000000000000000000000000000000000000001
11111111C1111000000000000000000000000000000000000000000000C00001
1111111111111110000000000000000000000000000000000000000000E00001
1111111111111111111111111111111111111111111111111111111111111111