11111111111111111111
1000C01110001C001111
10P10011101011101111
10010011101010001111
1111011C001010100011
1111C011001010100111
1111100C0110001100E1
11111111111111111111